# crappy dev level
0500000000
0011002000
0011004000
0000002000
0000000000
0020000300
0030000001
0000200011
0040001111
0000111111
